


F 20,20,20



C 200,200,200







NO ./assets/north_compass.xpm







SO ./assets/south_compass.xpm








WE ./assets/west_compass.xpm












EA ./assets/east_compass.xpm















1111111111111111111
1001001001001001001
1001001001001001001
1001001001001001001
1001001000001001001
100000000S000000001
1000011111111000001
1111000000000001111
1000000101010000001
1111111111111111111