NO ./assets/Diamond_Ore.xpm
SO ./assets/Diamond_Ore.xpm
WE ./assets/Diamond_Ore.xpm
EA ./assets/Diamond_Ore.xpm

F 103,103,103
C 103,103,103

1111111111
1000000001
1010101001
1000000001
1000N00101
1000000101
1000000101
1000000111
1000000001
1111111111